"a	:啊呵阿锕腌嗄吖",
"ai	:爱哎挨碍哀矮癌埃艾呆唉蔼隘砹皑欸嗳嗌嫒叆暧霭毐硙瑷锿",
"an	:安按岸暗案俺厂广庵鞍氨鹌桉胺埯唵铵谙黯犴垵垾𩽾盦",
"ang	:昂肮盎",
"ao	:傲袄凹拗奥澳懊熬坳敖媪遨骜嗷璈獒聱螯翱鏊鳌鏖圫岙奡嶅廒",
"ba	:把罢吧八爸巴拔扒芭疤耙捌跋靶霸叭坝笆钯粑鲅魃灞朳岜胈蚆羓菝鲃鲌",
"bai	:百白摆败伯拜柏掰呗佰捭稗擘",
"ban	:办半般板班搬伴版扮拌瓣绊斑扳颁阪坂柈钣瘢癍昄攽湴靽𨭉",
"bang	:帮膀棒绑傍蚌旁谤镑榜磅邦梆𠳐浜蒡玤蚄塝搒",
"bao	:报保包抱宝爆暴胞饱薄刨苞炮剥鲍褒瀑曝堡豹雹孢鸨趵葆龅煲褓",
"bei	:被备北背倍悲杯辈碑贝悖惫呗臂狈卑孛邶陂钡焙蓓碚褙鞴鐾𬇙庳琲椑鹎鞁糒",
"ben	:本奔笨夯坌苯贲栟畚锛倴犇",
"beng	:甭蚌绷蹦崩泵迸琫嘣甏镚祊浲",
"bi	:比必笔鼻避毕壁闭逼臂彼蔽币碧匕庇泌秘弊璧辟毙鄙痹吡妣畀贲荜毖哔秕陛荸铋俾敝婢筚愎弼蓖睥跸滗裨箅薜篦嬖髀濞襞芘坒佖沘邲诐苾珌舭狴萆庳皕赑馝觱鲾屄",
"bian	:边变便遍编辩扁辫辨鞭贬匾蝙卞弁抃苄汴忭砭笾煸褊鳊𨚕昪萹碥",
"biao	:表标彪杓飑俵婊裱摽骠膘飙镖鳔镳骉脿幖熛瘭儦藨瀌",
"bie	:别鳖憋瘪蹩咇",
"bin	:彬斌缤濒鬓滨玢傧摈槟殡膑镔豳髌宾邠",
"bing	:并病兵冰饼丙秉屏禀柄邴炳栟摒槟昺蛃",
"bo	:玻剥伯播博波脖拨勃膊薄柏菠渤魄驳搏卜簸舶泊跛孛帛钵钹铂饽亳啵鹁僰箔檗擘礴妭浡袯𬭛踣嶓镈欂",
"bu	:不部步布补捕怖卜堡簿哺埠卟钚埔逋晡瓿埗𬷕蔀𫐓醭",
"ca	:擦拆嚓",
"cai	:才材采菜财彩猜踩裁睬蔡偲",
"can	:参残蚕惨餐灿惭骖孱粲璨黪䅟",
"cang	:藏舱苍仓沧伧臧鸧",
"cao	:草操槽曹糙嘈漕螬艹𥕢艚",
"ce	:策测侧册厕恻",
"cen	:参岑涔梣",
"ceng	:层曾蹭噌嶒",
"cha	:查差察茶插诧叉岔茬喳刹汊杈衩姹搽猹馇楂槎碴锸𥻗嚓镲侘垞蹅檫",
"chai	:柴拆差豺钗侪虿茝瘥",
"chan	:产颤蝉缠单掺禅铲搀阐馋忏觇谄谗婵孱廛潺骣澶蟾巉羼镵辿刬旵浐梴啴蒇𬊤冁瀍襜儳韂躔",
"chang	:常长场厂唱肠倡尝昌倘猖裳敞畅偿伥苌怅昶菖徜阊惝娼嫦氅鲳玚𬬮鬯鲿",
"chao	:朝超潮吵抄绰剿巢嘲钞炒耖晁焯怊弨",
"che	:车彻扯撤尺澈坼砗掣㬚",
"chen	:沉晨趁尘衬辰沈陈称臣忱伧抻郴龀宸谌琛碜嗔瞋谶疢𬘭棽榇煁",
"cheng	:成程城称承乘诚盛撑呈逞铛澄橙秤惩丞枨柽琤埕骋蛏裎塍瞠宬珹珵铖偁庱牚赪酲澂憕",
"chi	:吃持尺迟翅齿池耻斥驰哧赤弛侈匙痴蚩叱饬坻茌炽鸱敕豉眵笞啻嗤媸墀踟瘛褫螭篪魑彳胣𫄨瓻痓摛傺漦",
"chong	:虫冲充重崇宠种忡舂铳憧艟茺㳘珫翀埫摏漴",
"chou	:抽臭仇愁瞅丑畴筹绸踌酬杻俦惆瘳雠稠帱犨",
"chu	:出处除初础楚触厨雏橱储躇锄畜矗刍杵怵绌俶楮滁搐蜍褚樗黜蹰亍䢺䝙琡摴濋憷斶𬺓",
"chua	:欻",
"chuai	:揣啜搋嘬踹",
"chuan	:船传穿串喘川舛氚钏遄椽堾腨噇",
"chuang	:创床窗闯疮幢怆漴",
"chui	:吹垂椎捶锤炊陲棰槌圌",
"chun	:春纯唇椿醇蠢鹑淳莼蝽堾瑃𬭚䲠",
"chuo	:绰戳啜辍龊踔逴惙",
"ci	:次此刺磁词瓷差兹祠赐伺辞雌慈茨疵跐鹚糍佽茈泚莿𫚖",
"cong	:从匆聪丛囱苁枞淙琮骢璁熜葱悰",
"cou	:凑辏腠玼",
"cu	:粗促卒醋簇徂殂猝酢蔟蹙蹴",
"cuan	:窜篡汆撺镩攒蹿爨",
"cui	:脆摧催衰崔悴翠粹萃啐淬毳瘁榱璀缞漼",
"cun	:村存寸蹲忖皴邨",
"cuo	:错措挫撮搓厝嵖嵯锉矬痤磋蹉莝脞棤瑳瘥鹾酂",
"da	:大打答达搭瘩耷沓怛妲笪嗒跶靼褡鞑垯荙哒炟鿎𫟼溚阘𨱏",
"dai	:代带待袋大戴呆逮歹贷怠呔岱迨玳殆埭傣嘚黛轪垈绐叇",
"dan	:但单担弹蛋淡胆丹诞旦耽石氮眈疸郸掸聃萏啖惮殚赕亶箪儋澹𬘘𫢸疍瘅憺丼",
"dang	:当党挡荡档铛凼砀宕垱珰菪裆谠𬍡筜𣗋",
"dao	:到道导倒刀岛稻盗叨祷捣悼氘焘捯纛蹈忉舠帱鱽",
"de	:的地得德底锝嘚",
"dei	:得",
"den	:扽",
"deng	:等灯登凳瞪蹬邓澄戥噔嶝磴镫憕璒",
"di	:地第敌底低帝弟的抵滴递堤迪提蒂涤嘀缔笛氐邸狄诋坻籴柢荻砥娣谛棣睇碲骶嫡翟镝玓茋菂𬱖羝觌媂𤧛髢䃅禘䗖踶鞮蹢",
"dia	:嗲",
"dian	:点电店典颠殿玷掂淀碘滇巅甸奠垫佃惦坫钿靛簟癜癫踮阽扂琔磹",
"diao	:掉调钓吊雕刁鸟叼凋铫貂碉鲷汈窎铞",
"die	:爹跌叠蝶迭谍碟垤堞耋喋牒蹀鲽昳咥绖瓞䏲𫶇",
"ding	:定顶订盯钉叮鼎丁锭仃玎町疔酊啶腚碇耵萣",
"diu	:丢厾铥",
"dong	:动东懂冬洞冻栋董咚侗垌峒氡胨恫鸫胴硐岽𬟽",
"dou	:都斗豆抖逗兜陡读痘蚪窦蔸篼剅钭",
"du	:度读独毒渡肚都堵督妒顿睹镀杜赌厾笃阇渎椟犊牍嘟黩髑蠹芏𬭊",
"duan	:断段短端锻椴煅簖缎塅瑖",
"dui	:对队堆兑敦怼碓镦祋",
"dun	:盾顿吨蹲墩不囤盹钝敦沌炖砘趸惇遁楯礅镦蹾",
"duo	:多朵夺躲踱驮咄垛哆度舵堕惰跺剁柁哚铎埵掇裰杕饳剟㙍亸",
"e	:饿恶额哦讹扼阿娥鄂遏噩鹅愕鳄呃俄峨蛾厄轭垩莪屙婀谔萼锇腭鹗锷颚苊砵涐崿𫫇𥔲",
"ei	:欸诶",
"en	:恩唔摁蒽嗯",
"er	:而二儿耳贰饵尔迩洱珥鸸铒佴陑咡鲕",
"fa	:发法乏伐阀筏罚珐垡砝",
"fan	:反饭翻犯范泛凡繁烦番返矾帆贩钒畈梵蕃樊幡璠燔藩蘩氾墦𫔍𬸪蹯",
"fang	:方放房防仿纺访妨芳坊肪彷枋昉钫舫鲂邡牥蚄",
"fei	:飞非费肥匪废肺妃吠诽菲沸芾狒怫淝悱绯斐腓扉痱榧蜚翡霏鲱啡剕𬴂棐镄篚",
"fen	:分奋粉份愤纷忿吩坟粪芬焚氛汾玢棻酚偾棼鼢鲼坋翂𣸣豮瀵",
"feng	:风封丰疯缝蜂峰锋逢冯枫奉凤讽沣沨砜俸烽葑酆浲唪堼崶赗",
"fo	:佛",
"fou	:否缶",
"fu	:服复父夫府妇负富副佛傅福付附浮幅腐伏肤符咐扶斧袱缚俘辅辐弗芙拂脯赋覆腹俯孵敷蝠抚甫赴凫讣芾呋孚拊苻茀阜怫绂驸茯罘氟郛祓莩蚨釜麸菔桴趺匐涪跗稃腑蜉鲋滏赙蝮幞黻馥黼芣㕮㳇玞绋韨枹砆𫓧洑琈艴𫖯鄜榑簠",
"ga	:轧夹尬咖尕旮伽尜嘎噶钆",
"gai	:改该概盖溉丐芥钙陔垓赅炌𬮿荄晐戤",
"gan	:干感赶敢杆肝甘柑竿乾尴橄赣秆玕旰坩苷矸泔绀酐疳淦澉擀㽏鳡",
"gang	:刚钢纲岗港缸冈扛杠肛罡戆冮㭎鿍堽筻",
"gao	:高告搞稿镐膏糕羔杲郜诰皋锆缟槔槁睾篙藁筶",
"ge	:个革各哥歌格隔割胳搁戈合阁盖葛蛤骼疙鸽仡圪纥虼咯鬲硌铬舸颌嗝膈镉哿袼塥滆",
"gei	:给",
"gen	:跟根哏亘艮茛珢",
"geng	:更耕庚埂耿颈羹梗哽绠赓鲠浭鹒",
"gong	:工共公功供攻巩贡拱宫弓红恭汞躬蚣肱珙龚觥䢼唝",
"gou	:够构狗沟勾钩购句苟垢佝岣诟枸缑彀媾觏篝鞲耇姤笱遘雊",
"gu	:姑古故固顾鼓骨股谷估孤沽贾雇咕钴菇汩诂呱轱牯鸪罟菰梏蛄蛊崮酤鹄觚毂锢痼榖鹘箍鲴臌瞽辜𦙶羖堌牿蓇馉嘏瀔",
"gua	:挂瓜刮卦括寡褂呱诖剐胍栝鸹坬",
"guai	:怪拐乖夬掴",
"guan	:关观管官馆惯灌贯罐冠纶矜莞倌掼涫琯盥鳏瓘鹳棺毌蒄祼筦爟鳤",
"guang	:光广逛犷咣胱垙洸珖桄𨐈",
"gui	:规鬼贵柜归轨跪闺癸桂瑰诡硅龟圭庋妫匦炅刿刽皈桧晷鲑簋鳜氿宄邽姽珪筀鬶",
"gun	:滚棍衮绲辊磙鲧",
"guo	:国过果锅裹郭涡埚掴帼馃聒椁蝈粿虢呙崞𬇹腘蜾馘",
"ha	:哈虾蛤铪",
"hai	:还孩海害咳嗨亥骇嘿嗐氦骸醢胲",
"han	:喊含汉寒焊旱汗罕函悍涵韩酣憨翰憾捍撼邗邯顸菡晗蚶焓颔阚鼾瀚扞犴虷垾浛琀崡嵅撖蔊暵㘎",
"hang	:行航夯吭杭巷沆绗颃",
"hao	:好号毫耗豪皓镐嚎壕浩昊郝蚝蒿嗥貉薅嚆濠颢灏侴淏鄗皞",
"he	:和合河何喝盒荷核呵禾吓赫鹤贺嗬褐纥诃劾曷饸阂盍盉菏涸颌貉阖翮壑鞨郃垎𬌗隺龁鹖熇翯龢",
"hei	:黑嘿嗨𬭶潶黒",
"hen	:很恨狠痕𬣳",
"heng	:哼横衡恒亨姮珩桁鸻蘅",
"hong	:红轰洪哄宏弘虹鸿烘讧吽闳泓訇竑蕻薨玒纮荭翃硔𫟹𬭎谼黉",
"hou	:后候厚猴吼喉侯逅鲎瘊骺篌齁郈垕堠𬭤鲘糇",
"hu	:乎忽呼护互湖户胡虎糊壶蝴许戏沪和弧核葫狐瑚唬惚囫怙戽烀浒祜笏瓠唿斛扈琥鹄猢煳鹕鹘滹槲縠醐觳冱昒昈岵轷隺淴鄠嫭鹱鳠",
"hua	:话化花划画滑哗华猾桦骅铧砉婳嬅",
"huai	:坏怀划淮徊槐踝",
"huan	:欢换环缓还唤幻患宦涣焕痪奂郇洹桓浣萑豢漶鲩圜寰缳鹮獾鬟荁峘𬘫逭㬊貆锾擐澴嬛𤩽镮",
"huang	:黄慌皇晃蝗荒幌簧煌恍谎凰惶肓隍遑徨湟潢璜篁蟥鳇磺㿠喤媓瑝滉锽艎𨱑癀",
"hui	:会回挥灰恢辉毁汇慧绘悔卉讳徊诲贿晦秽惠溃徽诙茴荟虺咴洄珲恚桧烩彗蛔喙翚蕙麾隳蟪㧑袆晖烠硊翙𬤝橞",
"hun	:混昏浑婚魂荤诨珲馄阍溷惛婫",
"huo	:活或火伙货获和豁霍惑祸耠嚄镬攉藿嚯蠖佸钬𬴃锪漷夥劐濩彟㸌",
"ji	:几己机级记计济极基集及技际击急积即纪激继既鸡季挤绩寄迹给剂辑寂疾肌圾脊饥籍叽忌妓其奇革唧祭骑期棘缉畸嫉箕稽鲫冀藉讥系吉玑芨乩岌伎汲矶虮佶诘亟荠笈洎剞觊笄屐姬偈悸戟赍殛戢犄嵇蓟蒺楫跻嵴麂霁鲚暨蕺稷瘠齑畿髻墼羁罽骥伋芰枅𬯀垍姞𪟝堲掎𫓯徛鱾惎𫓹𫌀跽漈鹡穄蹐𬶨𬶭瀱",
"jia	:家加价架假夹稼甲驾嫁贾钾嘉佳茄颊伽郏岬迦珈荚枷胛浃痂戛铗笳袈葭跏蛱镓泇叚恝𬂩斝嘏槚瘕",
"jian	:见间建件坚渐简检践减艰肩尖健监歼箭拣剑键兼剪鉴碱浅柬涧槛贱捡溅煎舰奸荐茧枧饯牮笕菅笺谏睑锏毽犍腱湔裥缄搛蒹缣戬僭踺鲣鞬蹇謇鞯俭戋𬣡趼楗谫翦鹣篯鳒",
"jiang	:将讲江降匠奖酱僵虹蒋强浆缰桨疆姜绛豇耩膙犟礓糨茳洚弶蔃鳉",
"jiao	:叫教较交脚角觉焦骄浇搅胶侥绞校矫跤礁嚼轿郊剿狡缴蕉娇椒窖饺艽佼茭峤姣铰皎蛟湫敫鲛噍徼鹪醮爝酵峧䴔滘斠僬漖璬皦皭",
"jie	:阶解结界接节姐街借介揭洁届截戒价劫芥桔秸楷藉竭杰捷睫皆诫孑讦疖玠劼诘拮疥阂蚧桀偈婕颉喈嗟碣羯岊㛃湝蜐骱耤鲒褯檞",
"jin	:进今紧近金仅尽斤劲禁巾筋浸锦晋津谨襟妗荩浕衿矜烬堇靳缙馑瑾觐槿噤卺𬬱珒赆琎祲溍瑨廑殣",
"jing	:经睛精静惊竟景镜境警净井敬竞径鲸晶劲京荆靖兢腈茎颈阱刭肼泾胫痉菁旌婧靓粳儆憬璟汫迳倞猄竫𫟅䴖獍璥麖鼱丼",
"jiong	:窘炯炅迥扃颎囧冏坰泂𬳶䌹",
"jiu	:就九究旧久酒救舅纠揪啾臼玖灸疚韭鸠咎赳柩桕阄厩鹫鬏氿僦㠇",
"ju	:据具句举局巨居距剧聚拒橘车且柜炬沮矩鞠拘俱惧咀锯桔菊驹讵苣苴狙莒枸倨疽掬焗琚趄椐锔犋飓蒟榉龃雎裾踞屦遽踽鞫岠弆岨泃钜秬崌娵筥腒𬶋䴗窭澽醵",
"juan	:卷娟眷倦绢鹃捐圈隽狷涓鄄锩镌蠲桊",
"jue	:决觉绝诀倔崛脚爵撅嚼角掘孓抉玦珏桷厥谲蕨噘獗橛噱镢蹶矍爝攫𫘝叕砄觖傕劂㵐𫔎𨟠玃",
"jun	:军均菌君龟钧俊骏竣峻郡捃隽浚皲筠麇莙珺晙焌畯䐃𫖳鲪",
"ka	:卡拤咔咯喀咖胩",
"kai	:开慨凯楷揩忾剀闿恺铠锴炌垲蒈锎",
"kan	:看砍刊嵌堪槛勘坎侃龛戡阚瞰衎莰崁墈磡",
"kang	:抗炕康扛亢糠慷伉闶钪𡐓𩾌",
"kao	:靠考烤拷铐尻栲犒㸆洘",
"ke	:可科刻客课颗克棵壳渴咳坷苛磕瞌蝌岢珂剋柯轲恪牁疴氪骒颏缂嗑锞稞溘窠髁匼炣悈",
"kei	:剋",
"ken	:肯恳啃垦裉龈𬒔",
"keng	:坑吭铿硁",
"kong	:空控孔恐倥崆箜埪硿",
"kou	:口扣叩抠寇眍蔻芤𫸩筘",
"ku	:苦哭库裤酷枯窟刳绔喾骷矻朏圐",
"kua	:跨夸垮挎侉胯姱",
"kuai	:快块筷㧟侩哙狯浍脍蒯会郐鲙",
"kuan	:宽款髋",
"kuang	:况矿狂筐框眶旷邝匡圹夼诓哐贶诳纩洭𫛭",
"kui	:亏愧馈魁窥盔葵溃岿奎悝逵匮傀馗隗揆喹喟愦暌跬睽聩蝰篑夔𫠆蒉骙煃戣櫆",
"kun	:困昆捆坤阃琨焜髡锟醌鲲悃壸堃裈婫鹍",
"kuo	:括扩阔适廓蛞",
"la	:啦拉蜡垃腊喇辣落旯剌瘌鞡邋镴砬蝲𬶟",
"lai	:来莱睐赖崃徕涞赉铼濑癞籁俫梾",
"lan	:烂蓝篮拦览栏懒兰婪揽缆榄澜滥岚阑罱谰褴斓镧暕𬒗漤襕",
"lang	:浪狼朗郎琅廊榔莨阆啷锒稂蒗螂埌崀桹㫰烺蓢筤塱㮾",
"lao	:老劳捞牢姥络唠烙涝落酪佬栳崂铑痨耢潦醪荖𫭼铹嫪橑",
"le	:了乐肋勒仂叻泐饹鳓簕",
"lei	:类泪累雷肋擂蕾垒勒耒诔酹嘞嫘缧儡镭羸磊檑藟礌癗罍厽",
"leng	:冷愣棱崚塄祾堎楞",
"li	:里力理利立历离例哩丽璃厉礼粒励隶厘李吏俐莉栗雳痢漓黎沥荔狸篱梨鹂鲤砾犁苈呖枥疠戾栎郦俪俚疬莅鬲逦砺猁娌骊蛎唳笠粝喱跞詈锂傈蓠蜊溧缡嫠鲡罹篥澧藜醴黧鳢蠡朸坜𫵷叕𬍛轹峛珕浬凓漦醨釐㰀刕",
"lia	:俩",
"lian	:连脸联炼练怜帘莲敛镰廉恋奁涟琏梿殓裢楝潋鲢濂蠊链浰裣瑓蔹磏𬶠",
"liang	:两量亮粮良辆梁凉谅俩粱晾靓椋踉魉俍𬜯倞悢辌墚",
"liao	:料了瞭疗僚辽寥嘹缭聊撩撂尥钌蓼廖獠潦寮燎鹩镣蹽𪤗憭嫽簝髎",
"lie	:烈列猎裂咧劣冽洌埒捩趔躐鬣䴕𫚭劦",
"lin	:林临淋邻吝拎赁琳凛鳞躏磷啉蔺粼嶙遴璘霖辚膦廪檩麟𬘭箖潾𬴊懔瞵𬭸翷厸",
"ling	:领另令零灵铃岭龄陵凌聆菱羚棱伶玲苓呤囹泠瓴棂蛉崚翎绫祾鲮酃〇坽姈柃昤鸰舲㥄澪",
"liu	:流六留榴柳溜硫刘陆浏琉碌馏瘤绺遛旒骝熘镏镠鎏珋锍飗罶鹠瑬疁鹨",
"lo	:咯",
"long	:笼龙拢隆胧弄聋垄咙窿陇茏泷珑栊砻眬癃昽哢𬕂漋",
"lou	:楼漏喽娄篓露搂偻蒌嵝䁖镂瘘耧蝼髅陋剅𪣻溇",
"lu	:路露陆炉录芦虏六卢卤庐赂颅绿鲁禄碌鹿垆泸栌轳胪辂鸬掳舻渌逯鲈箓漉撸辘噜戮橹氇潞璐鹭麓甪𬬻菉𫘧琭稑僇勠澛蕗镥簏",
"luan	:乱卵峦孪娈栾挛鸾脔滦銮",
"lue	:掠略锊",
"lun	:论轮纶仑伦沦抡囵𫭢𬬭",
"luo	:落骆罗洛烙啰裸螺锣络萝逻骡泺荦咯珞捋硌猡椤跞摞雒漯瘰箩倮脶蓏蠃",
"lv	:律绿率旅虑驴铝吕侣氯屡滤履缕闾捋偻榈膂褛垏梠稆葎𦝼",
"lve	:䂮圙",
"m	:呒呣",
"ma	:妈吗马嘛骂麻码蚂么玛摩蟆抹犸麽孖杩祃",
"mai	:买卖麦脉埋迈劢荬唛霾鿏",
"man	:满慢漫馒瞒曼蛮蔓埋谩墁幔嫚缦颟螨镘鳗𬜬鞔鬘",
"mang	:忙茫盲芒莽氓邙牤硭漭蟒杧厖牻",
"mao	:毛矛帽冒貌猫贸卯锚茂茅髦牦芼茆峁泖眊昴耄铆旄袤瑁瞀蝥懋蟊鄚楙",
"me	:么麽",
"mei	:没每美妹煤眉梅霉玫媒媚魅昧枚镁酶袂莓郿嵋湄寐楣鹛糜浼渼媄瑂镅",
"men	:们门闷扪焖懑钔𫞩鞔亹",
"meng	:猛梦蒙盟朦氓孟萌锰檬虻勐甍蜢艋瞢獴懵蠓艨濛𫑡㠓幪鹲礞",
"mi	:米密秘迷蜜眯觅咪谜靡弥泌汩汨宓祢弭脒猕幂谧嘧醚糜縻麋芈狝洣祕敉蓂蘼醾",
"mian	:面棉免眠勉缅绵丏沔眄娩冕渑湎腼勔偭愐𩾃",
"miao	:秒妙苗描庙藐渺瞄杪眇喵缈鹋缪邈淼厸",
"mie	:灭蔑乜咩篾",
"min	:民敏皿闽悯抿闵旻黾岷泯珉缗玟苠湣碈愍鳘",
"ming	:命明名鸣冥铭茗酩溟暝瞑螟洺蓂",
"miu	:谬缪",
"mo	:模摸默磨漠莫膜魔末抹墨没沫寞陌万么茉冒脉馍摹嘿摩蘑殁秣谟蓦貊嫫靺麽瘼貘嬷耱镆藦𬙊瞐",
"mou	:某谋牟侔哞眸缪鍪蛑",
"mu	:目母木幕亩牧模沐姥募睦暮慕墓姆牡拇穆仫牟呒苜钼毪𬭁𧿹",
"n	:嗯唔",
"na	:那哪拿钠娜捺纳呐衲肭乸𦰡镎",
"nai	:奶耐乃奈艿氖柰萘鼐佴迺耏",
"nan	:难南男喃囡赧楠腩蝻萳婻",
"nang	:囊曩攮囔馕齉",
"nao	:脑闹挠瑙恼呶孬硇铙淖蛲猱垴峱臑",
"ne	:呐呢哪讷",
"nei	:内那哪馁",
"nen	:嫩恁",
"neng	:能",
"ng	:嗯唔",
"ni	:你泥尼妮逆匿腻溺拟呢坭怩昵铌倪旎睨霓鲵伲𨺙猊𫐐𫠜薿麑",
"nian	:年念黏粘辗捻碾撵廿拈埝辇鲇蔫菍",
"niang	:娘酿",
"niao	:鸟溺尿茑袅脲",
"nie	:捏聂摄孽乜臬涅啮嗫镊镍颞蹑蘖陧嵲𫔶糵",
"nin	:您恁",
"ning	:凝拧狞泞柠宁咛佞苧聍甯",
"niu	:牛扭拗钮纽忸妞杻狃",
"nong	:农弄浓脓侬哝秾𬪩",
"nou	:耨",
"nu	:努怒奴帑弩孥驽胬砮笯",
"nuan	:暖",
"nue	:疟虐",
"nuo	:挪娜诺懦糯喏傩搦𦰡锘",
"nv	:女钕衄恧",
"o	:哦喔噢嚄",
"ou	:偶区呕殴藕欧鸥讴沤怄瓯𬉼耦𠙶髃",
"pa	:怕爬啪趴扒耙帕杷钯琶葩筢舥潖",
"pai	:派排拍牌迫徘湃哌俳蒎簰",
"pan	:判盘盼叛攀胖番潘畔爿泮袢磐蹒蟠襻槃磻",
"pang	:旁胖膀磅螃乓庞彷逄雱滂耪尨鳑",
"pao	:跑炮泡抛袍咆刨狍庖疱匏脬脟",
"pei	:配培陪呸胚佩赔帔旆辔裴醅霈沛衃锫",
"pen	:盆喷湓",
"peng	:朋碰捧棚膨烹彭鹏蓬怦篷砰澎抨堋椪硼嘭蟛芃浲弸搒",
"pi	:批皮披脾匹疲辟屁譬否僻霹坯劈啤丕圮邳陂纰枇砒毗蚍铍郫埤淠琵痞睥裨媲蜱罴噼貔癖鼙仳苉伾狉𬳵陴鲏澼甓䴙嚭",
"pian	:片篇偏骗便扁翩骈胼谝犏蹁𡎚㛹楩",
"piao	:票飘漂朴瓢莩殍剽嘌嫖骠缥瞟螵蔈薸",
"pie	:撇瞥苤氕𬭯",
"pin	:品拼贫频聘牝玭姘嫔颦𬞟",
"ping	:平评凭瓶苹坪萍乒屏枰娉鲆泙玶荓帡俜洴涄蚲淜𬞟",
"po	:破迫婆坡泼颇朴繁泊魄叵钋陂泺珀䥽笸粕鄱皤哱钷桲酦馞",
"pou	:剖抔掊裒垺棓",
"pu	:普铺扑朴葡仆圃浦堡蒲谱暴曝脯瀑菩匍埔莆溥噗璞氆濮蹼蒱酺墣潽镤镨穙",
"qi	:起气其期七器汽奇企旗齐骑漆妻启欺戚岂弃乞迄歧祈契柒栖脐缉稽鳍砌棋凄泣崎沏亓讫芑屺汔祁圻芪杞岐祇亟荠俟耆桤颀萁萋畦淇骐绮琪琦葺蛴祺碛锜綦嘁蜞蕲槭憩蹊麒𨙸玘呇𬨂洓郪埼䓫跂婍欹棨愭碶觭磜鲯",
"qia	:恰卡洽掐袷髂葜",
"qian	:前钱千牵浅签铅欠潜迁纤乾遣黔谦歉钳嵌谴仟阡扦芊芡佥钎茜荨钤虔倩悭掮堑椠犍愆鹐慊骞搴褰缱圲杄岍汧肷𬘬靬蒨墘",
"qiang	:强枪墙抢腔呛羌戗炝戕跄羟蜣蔷锵嫱樯镪襁玱矼锖蔃",
"qiao	:桥瞧悄巧敲乔壳侨俏窍雀翘跷撬憔锹峭荞峤诮硗愀劁谯鞒鞘橇樵缲硚燋",
"qie	:切且窃茄怯伽郄妾挈惬趄慊锲箧癿磜",
"qin	:亲侵勤琴芹沁秦禽寝擒钦芩吣矜衾骎揿覃嗪溱噙檎嵚锓墐廑慬",
"qing	:情轻青清请倾晴庆亲卿擎顷蜻氢苘圊氰箐綮磬檠罄黥勍庼碃鲭",
"qiong	:穷琼邛茕穹筇蛩䓖銎",
"qiu	:求球秋丘仇囚龟蚯犰虬邱泅俅酋逑赇遒湫巯楸裘糗鳅鞧訄萩𨱇鹙璆蝤鼽",
"qu	:去区取趣曲渠屈娶趋岖驱躯苣劬朐祛鸲蛆蛐阒蕖觑磲璩龋瞿蘧黢氍癯衢𫭟诎坥㭕𪨰胠竘袪䓛焌麹鼩灈蠼",
"quan	:全权圈劝拳泉券痊犬诠荃畎悛铨绻筌蜷醛鬈颧佺辁婘棬瑔鳈𨟠",
"que	:却确缺雀瘸鹊炔悫阕阙榷埆𬒈隺𨟠",
"qun	:群裙逡麇囷",
"ran	:然燃染冉苒髯蚺䎃",
"rang	:让嚷壤瓤攘禳穰蘘瀼",
"rao	:绕扰饶娆桡荛",
"re	:热惹喏",
"ren	:人认任忍刃壬仁纫韧仞轫饪妊纴荏衽葚稔讱菍",
"reng	:仍扔",
"ri	:日驲",
"rong	:容荣溶冗戎蓉绒融熔茸榕狨嵘蝾瑢镕",
"rou	:肉柔揉蹂糅鞣",
"ru	:如入汝褥儒乳辱蠕茹洳铷蓐溽缛薷嚅濡孺襦傉嬬颥",
"ruan	:软阮堧媆瓀",
"rui	:锐瑞蕊芮蚋睿蕤汭枘惢",
"run	:润闰",
"ruo	:弱若偌箬叒鄀婼蒻爇",
"sa	:撒洒萨卅仨飒挲靸脎",
"sai	:赛塞腮噻鳃",
"san	:三散伞叁糁馓毵潵",
"sang	:嗓丧桑搡颡磉",
"sao	:嫂扫骚臊搔埽瘙缫缲溞",
"se	:色涩瑟塞啬铯穑㴔璱",
"sen	:森",
"seng	:僧",
"sha	:沙杀啥纱傻砂杉鲨刹厦煞霎莎唼铩挲痧嗄歃裟",
"shai	:晒色筛骰酾",
"shan	:山闪善扇删单陕栅禅煽擅赡衫杉珊讪汕芟苫疝姗舢剡掸跚骟鄯潸缮膳嬗膻蟮鳝钐埏𫮃掞晱墡嶦",
"shang	:上商伤尚赏裳晌汤垧殇绱觞墒熵",
"shao	:少烧绍稍哨梢勺召捎芍杓邵劭苕蛸筲艄韶潲鞘玿柖",
"she	:社设射摄舍蛇舌涉赦奢折厍佘赊猞阇畲慑歙麝𪨶滠虵",
"shei	:谁",
"shen	:什甚身神深伸婶审慎渗沈肾参申绅呻诜哂胂莘砷谂娠葚蜃瘆糁屾侁珅矧𬳽𬬹甡椹鲹燊瞫",
"sheng	:生声胜省剩升牲绳盛乘笙甥圣晟渑嵊昇陞眚",
"shi	:是时十事实使世识师石史市始似士式失示食势室视试适施湿诗驶释拾蚀氏饰逝什矢柿恃殖嗜誓狮侍尸屎拭匙仕豕虱贳峙炻埘莳轼铈舐弑湜谥蓍筮嘘奭鲥噬螫邿鸤䴓䏡浉祏栻𬤊酾𫚕鲺鼫襫",
"shou	:手受收首守授瘦售兽熟寿狩绶艏",
"shu	:书数术树熟属叔束输舒述殊鼠蔬抒沐竖恕梳庶淑赎蜀墅漱曙署疏枢暑薯戍纾沭俞姝秫倏菽孰黍摅毹腧塾澍殳陎𬬸鄃婌",
"shua	:刷唰耍",
"shuai	:摔率甩蟀衰帅",
"shuan	:拴栓涮闩礵",
"shuang	:双霜爽泷孀骦鹴",
"shui	:水谁睡说税帨",
"shun	:顺吮瞬舜楯",
"shuo	:说硕数烁妁铄朔搠蒴槊",
"si	:四思死似司丝私斯撕饲巳寺伺祀食肆嘶汜兕姒咝泗驷俟鸶耜笥蛳缌嗣厮锶澌㟃虒涘偲楒飔凘",
"song	:送松耸颂宋讼诵㧐忪怂凇悚菘淞竦嵩娀崧",
"sou	:搜嗽艘叟嗖馊溲飕嗾螋擞薮蒐廋瞍锼",
"su	:速诉素肃塑宿俗苏粟酥溯缩夙涑谡嗉稣愫窣僳觫簌𫗧骕甦傃鹔蔌蹜",
"suan	:算酸蒜狻",
"sui	:随虽岁碎尿祟隋遂髓隧穗荽谇绥眭睢燧濉邃璲𫟦𬭼穟襚旞",
"sun	:损笋孙荪狲隼飧榫",
"suo	:所缩索锁唆梭嗦琐莎唢娑桫挲睃蓑嗍羧葰溹惢",
"ta	:他她它踏塔塌拓蹋沓挞闼趿铊嗒遢溻榻漯褟獭鳎鿎溚鞳",
"tai	:太台态抬胎苔泰呔邰肽骀钛炱酞跆鲐薹汰咍",
"tan	:谈探叹坦炭摊弹滩碳坛贪谭瘫檀毯潭痰坍忐昙钽郯袒覃澹倓菼惔榃锬璮",
"tang	:躺堂糖趟塘汤倘唐烫棠膛淌搪帑惝傥溏耥瑭嘡樘羰镗螳蹚铴鄌䣘镋螗",
"tao	:讨套逃掏桃萄淘叨陶涛滔洮绦焘啕韬饕弢梼𫘦绹慆鼗",
"te	:特忑忒慝铽",
"tei	:忒",
"teng	:疼腾誊藤熥滕螣縢䲢",
"ti	:体题提替踢梯剃屉惕蹄涕剔啼荑俶倜逖悌绨锑鹈缇醍嚏鳀遆𫘨瑅裼䴘",
"tian	:天田添甜填佃恬舔忝殄畋钿腆湉阗沺掭淟晪黇",
"tiao	:条跳调挑迢粜眺苕佻笤窕蜩髫朓祧龆鲦嬥",
"tie	:铁贴帖萜餮",
"ting	:听停挺庭厅亭廷艇蜓汀町莛烃梃铤葶婷霆圢侹𬘩珽烶珵桯颋渟䗴",
"tong	:同通统痛铜桶童筒彤捅桐瞳佟侗垌茼峒恸砼酮嗵僮潼仝峂𫍣哃烔㛚鲖橦曈𦒍",
"tou	:头透投偷骰钭",
"tu	:土图突途涂徒吐兔凸屠秃钍荼堍菟梌葖稌腯酴㻬",
"tu2	:𬳿",
"tuan	:团抟湍疃彖猯煓",
"tui	:推腿退蜕颓褪忒煺𬯎魋",
"tun	:屯吞囤豚褪臀饨鲀暾坉焞",
"tuo	:脱拖驼托妥拓鸵魄驮唾椭佗陀坨沱柝柁砣铊庹酡跎橐鼍侂萚𬶍箨",
"wa	:挖哇娃蛙瓦袜洼佤娲畖窊腽",
"wai	:外歪崴",
"wan	:完万晚碗玩弯挽顽宛婉皖腕蔓湾惋丸芄纨莞剜菀脘烷绾琬塆畹蜿豌𬇕婠椀",
"wang	:往望忘王网亡妄旺枉汪罔惘辋魍尪罒",
"wei	:为位委围伟微维卫未危味唯威谓尾喂惟违胃慰伪纬苇萎帷尉遗蔚薇魏畏偎猬桅巍韦圩帏闱沩玮炜洧涠诿娓逶隈隗葳崴嵬猥渭韪痿煨鲔潍霨𫇭𣲗𬀩峗洈琟𬱟廆艉煟溦碨𬶏𬭬鳂螱鳚",
"wen	:问文温稳闻纹蚊紊瘟蕴吻刎汶雯璺芠𫘜玟忞炆阌碈辒鳁",
"weng	:嗡翁瓮蓊滃𬭩鹟蕹",
"wo	:我握窝卧涡沃蜗肟挝莴倭喔幄渥斡踒龌偓涴硪",
"wu	:物无五务屋误武午伍舞污雾乌悟恶侮亡勿戊芜巫吾吴梧鹉捂诬呜蜈兀毋圬仵邬坞杌迕庑怃忤妩钨唔浯晤牾焐靰铻痦婺骛寤鹜鋈鼯屼芴𣲘旿於郚洿珸珷鹀榅",
"xi	:西系细习席息喜吸希洗戏析惜悉牺稀媳袭嘻溪膝晰隙熄夕昔栖徙腊熙锡蟋犀兮汐饩茜郗郤恓唏奚玺浠觋硒晞铣阋烯淅葸舄翕粞皙禊豨蜥僖屣潟嬉熹樨螅歙羲窸禧隰檄蹊醯曦屃肸穸咥俙饻枲绤菥𠅤睎傒舾㴔碏裼𫘬蓰嶍嶲憙暿熻𬭳谿鳛巇酅𬶮爔鼷觿",
"xia	:下夏吓峡瞎虾狭匣侠唬厦暇辖霞呷狎柙硖遐瑕罅黠叚翈",
"xian	:现先线显见县鲜限险纤献闲陷掀宪嫌仙贤洗腺羡弦衔咸馅苋岘氙冼祆挦籼涎蚬猃娴铣舷痫鹇酰跣跹锨暹藓燹霰伣伭忺𬀪狝𪾢盷莶崄𫍯筅缐禒㬎𬸣孅",
"xiang	:想象向相响乡项像香箱详享降巷湘橡祥厢镶芗饷庠缃飨鲞襄骧翔珦葙儴𬙋瓖",
"xiao	:小笑消校效销晓肖宵削孝萧淆潇霄嚣啸哮硝箫枭枵哓骁逍鸮绡崤睄蛸筱魈藠洨恔虓涍猇𫍲翛敩滧漻皛蟏咲",
"xie	:些写谢鞋械协斜歇血胁叶邪泻契谐解蝎懈蟹卸携挟泄屑绁偕揳颉亵渫楔榭撷勰缬薤獬邂廨澥燮瀣躞偰絜𬹼觟榍㙦薢𤫉劦",
"xin	:心新信辛欣馨薪寻芯锌衅囟忻昕炘莘歆镡鑫伈䜣𫷷",
"xing	:行性形兴星型幸姓醒刑杏省猩腥邢饧陉荇荥硎悻惺擤𫰛钘骍铏婞瑆煋",
"xiong	:雄胸兄凶熊匈汹芎讻诇夐",
"xiu	:修休袖秀朽臭羞绣锈宿嗅岫咻庥琇貅馐滫溴髹珛脩鸺䗛",
"xu	:许需须续序绪虚戌旭恤酗絮婿墟徐吁叙畜蓄圩盱诩洫浒胥顼栩勖媭溆煦蓿嘘魆𬣙旴砉昫㳚珝垿冔谞欻湑糈醑𦈡",
"xuan	:选宣旋悬玄轩县券炫喧渲癣漩绚暄泫眩铉烜谖萱瑄楦煊璇𫠊玹咺昡晅痃琄衒𫓶愃暅碹暶儇禤𫍽翾",
"xue	:学雪血削穴薛靴茓谑踅噱鳕峃敩",
"xun	:迅训讯寻循驯勋殉旬询熏汛巡郇荀荨峋徇洵浔恂珣埙浚巽鲟窨蕈薰曛醺逊𬘓𬩽𬍤栒𬊈噀獯𫄸",
"ya	:呀压牙鸦丫崖鸭押讶芽涯雅亚轧衙蚜哑伢迓岈玡垭娅氩揠睚吖砑姶琊桠堐猰",
"yan	:眼研验严烟演言沿颜掩岩盐厌燕延炎淹咽艳宴焰砚唁铅殷焉阎谚雁蜒檐堰衍芫妍奄兖俨彦恹晏胭剡郾崦偃阉阏琰筵腌焱湮鄢罨滟酽嫣魇餍谳赝鼹闫觃沇阽埏䶮弇𫄧烻厣棪渰扊墕𬸘漹𬙂蝘虤𪩘黡嬿甗",
"yang	:样阳养央洋羊扬氧杨仰秧殃鸯漾痒旸炀佯疡泱怏徉恙烊蛘鞅卬飏咉钖垟羕",
"yao	:要药摇咬腰窑耀吆么夭尧约妖侥肴疟姚陶邀遥舀谣钥幺爻杳峣珧窈铫徭瑶靿鹞繇曜鳐垚轺窅㙘崾猺媱",
"ye	:也业爷夜野叶液冶页邪拽椰腋咽曳邺耶烨揶掖谒靥噎晔倻铘堨楪馌",
"yi	:一以义意已衣艺议易医依益移亿疑异役仪忆椅遗宜译姨抑乙咦蚁亦倚艾夷邑尾矣怡绎贻胰谊蛇逸壹溢毅翼屹伊疫乂弋刈匜仡圯钇苡呓佚沂诒峄迤佾饴怿祎诣驿荑轶咿弈奕羿挹眙浥悒埸铱猗痍翊翌揖颐嗌肄裔缢蜴旖漪镒熠薏殪螠噫劓翳嶷臆黟癔彝懿杙佁枍𬬩㑊叕昳舣洢酏宧扅扆勚𫖮㴔椸裛廙瘗潩嫕鹝踦鹢𬺈燚𫄷繄簃𬟁镱",
"yin	:因音引印银阴隐饮茵荫殷淫寅瘾吟姻蚓尹吲茚垠胤洇氤狺訚铟堙喑湮愔鄞龈夤窨霪骃𬘡珢硍崟𬤇龂𬮱歅䲟溵禋慭蟫嚚",
"ying	:应影营映英硬迎蝇婴荧盈莺樱鹦赢鹰萤莹颖茔荥郢萦瑛颍蓥楹媵滢撄嘤罂缨璎瘿嬴膺瀛䓨媖溁锳潆",
"yo	:哟唷",
"yong	:用永勇涌拥佣咏踊泳甬俑痈邕恿喁蛹雍墉慵颙镛壅臃鳙饔庸栐㶲埇㛚鄘鲬澭",
"you	:有又由油友右游优尤幼犹邮酉幽忧铀悠诱佑卣攸呦侑柚囿疣羑宥莠莜莸蚰蚴釉鱿猷蝣牖黝繇鞧鼬尢祐浟铕𬨎鲉麀槱蝤戭耰",
"yu	:于与育雨鱼余语遇预宇愈域玉狱愉欲御渔予豫誉迂芋屿谷禹浴淤尉隅喻逾渝榆蔚裕羽娱竽郁吁寓驭伛聿纡玙欤饫妪妤盂臾禺昱俣俞彧圄峪钰狳谀堉萸雩圉庾阈谕揄喁嵎嵛鹆腴瑜虞觎瘐煜滪蜮毓龉蝓窳熨燠鹬鬻舆愚邘於舁峿敔鄅悆淯隃棫畬㺄矞瑀蓣艅瘀窬褕隩薁潏遹燏",
"yuan	:员原远院愿源元园圆援猿缘冤怨苑袁鸳渊芫沅鸢垣爰垸鼋掾湲媛瑗塬辕箢橼螈圜妧眢暅蜎嫄𫘪薳羱",
"yue	:月越约跃乐岳钥说粤悦阅曰刖玥栎哕钺樾龠𫐄焆𬸚瀹趯爚籥",
"yun	:运云允匀孕员陨耘酝韵晕蕴芸狁纭昀郓郧恽殒愠韫氲筠鋆熨赟沄妘涢缊筼煴蕰馧",
"za	:杂砸扎咂咋匝臜拶",
"zai	:在再载灾栽仔哉宰甾崽",
"zan	:咱赞暂昝糌錾簪攒瓒趱拶寁",
"zang	:脏赃藏奘牂臧葬驵",
"zao	:造早遭糟皂凿躁燥蚤藻灶澡枣噪唣璪慥簉𥖨",
"ze	:则责择咋侧泽仄昃迮啧帻舴箦赜岞鲗",
"zei	:贼鲗",
"zen	:怎谮",
"zeng	:增综曾憎赠锃缯甑罾鄫矰䎖",
"zha	:扎炸眨渣轧乍诈咋查栅喳榨蜡闸札拃柞咤砟蚱铡揸喋楂吒挓奓哳痄溠鲊䃎劄鲝霅齇",
"zhai	:摘宅窄债择侧斋寨翟瘵",
"zhan	:战展站占盏沾崭斩栈绽辗颤粘毡瞻拃旃湛詹谵蘸飐栴偡嵁搌嶦𫗴鹯鳣",
"zhang	:长张章掌帐仗丈障涨胀杖账彰樟仉嶂幛獐漳璋瘴蟑鄣嫜暲",
"zhao	:找照着召招罩兆沼赵昭肇嘲爪朝钊诏笊啁棹𬬿旐𬶐曌",
"zhe	:这着者折哲遮浙辙蔗柘辄蛰蜇锗谪赭磔鹧褶螫晢啫喆詟䗪",
"zhei	:这",
"zhen	:真阵针震镇珍振侦枕诊贞疹斟圳轸帧胗鸩桢砧畛朕祯赈蓁甄溱缜榛箴臻纼昣浈袗揕葴椹瑧瑱禛稹鬒",
"zheng	:正政争整证征睁蒸挣症丁拯狰筝郑怔诤峥钲铮烝憕",
"zhi	:只知之志制指直治质至织支纸止值致置枝执植职殖智帜秩脂肢蜘氏旨吱识侄挚趾窒滞址稚掷芝卮芷豸沚郅帙炙祉栉枳栀峙胝祗咫陟贽桎轾埴鸷痔跖蛭痣骘彘酯雉摭踬踯徵觯汁𨙸扺忮𦭜泜轵庤茝晊梽畤铚絷𬃊黹媞跱锧稙滍禔榰疐擿蹢",
"zhong	:中种重众钟终仲衷忠肿忪盅冢踵螽茽柊舯锺穜",
"zhou	:周洲宙皱粥轴州肘昼骤舟帚咒纣诌㤘妯绉荮胄棁啁碡繇籀㑇酎辀鸼婤椆赒",
"zhu	:主住助注逐著筑珠竹祝猪柱株烛煮铸嘱蛛驻术朱贮属瞩诸拄蛀伫苎杼邾竺侏诛茱炷洙铢渚瘃褚翥槠箸潴麈躅𬣞纻柷砫疰舳橥蠋",
"zhua	:抓爪挝髽",
"zhuai	:拽",
"zhuan	:转专砖撰赚传䏝啭颛篆馔耑瑑",
"zhuang	:装庄状壮撞桩妆幢奘僮戆漴",
"zhui	:追椎锥赘缀坠骓惴缒隹倕",
"zhun	:准屯谆肫忳窀𬘯䐃衠",
"zhuo	:桌著着捉灼拙卓浊酌琢缴啄斫倬浞诼棁涿焯䦃擢濯镯茁汋叕䓬椓晫禚𬸦",
"zi	:子自资字仔紫姿吱咨兹滋姊籽孜呲秭恣梓眦渍淄缁辎嗞嵫孳趑訾锱滓龇髭鲻孖耔茈虸赀笫鄑粢觜镃鼒",
"zong	:总宗综纵棕踪枞疭偬粽鬃倧腙鬷",
"zou	:走奏揍邹诹陬驺鄹鲰",
"zu	:组族祖足阻租卒诅俎菹镞珇砠崒",
"zuan	:钻赚攥缵纂躜",
"zui	:最嘴罪醉咀蕞觜槜",
"zun	:尊遵撙樽鳟僔僎噂嶟𨱔",
"zuo	:作做坐左座昨佐凿撮琢怍柞胙祚唑捽笮酢嘬阼岞"